1111111111111111111111
1P00100000000001000001
1000C00100010010000001
100100000C0000C0000001
10000C00000010000E0001
1000100001000010000001
1111111111111111111111