11111111111111
1E000000000001
1000000K000001
10J00C0C000001
1P0000C0000001
11111111111111