11111111111111
100000C0000001
1P001000100001
100000000C0001
100000C00000E1
11111111111111
