11111111111111
1E000000000001
10000000000001
10000C0C0000011
1P0000C0000001
11111111111111