11111111111111
1E000000000001
10000000000001
10000C0C000001
100000C0000001
11111111111111