11111111111111
10000000000001
10000000000001
10000C0C000001
1P0000C0000001
11111111111111